int1,int2,double1,double2,expectedInt,expectedDouble,iterations
1,2,3.5,4.5,-1,8.0,100
-1,-2,-3.5,-4.5,1,-8.0,100
0,0,0.0,0.0,0,0.0,100
1000,-1000,999.99,-999.99,2000,0.0,100
-1000,1000,-999.99,999.99,-2000,0.0,100
500,500,0.1,0.1,0,0.2,100
-500,-500,-0.1,-0.1,0,-0.2,100
333,666,333.33,666.66,-333,999.99,100
-333,-666,-333.33,-666.66,333,-999.99,100
100,-50,50.5,-25.25,150,25.25,100
