int1,int2,double1,double2,expectedInt,expectedDouble,iterations
1000,500,1.234,5.678,500,6.912,100
500,250,10.23,45.67,250,55.900000000000006,100
250,125,0.123,0.456,125,0.579,100
125,63,123.45,678.9,62,802.35,100
-250,125,-1.23,-4.56,-375,-5.789999999999999,100
-125,-63,-123.45,-678.9,-62,-802.35,100
0,0,0.0,0.0,0,0.0,100
999,-999,999.999,-999.999,1998,0.0,100
-500,-250,-10.23,-45.67,-250,-55.900000000000006,100
-1000,500,-1.234,-5.678,-1500,-6.912,100
