int1,int2,double1,double2,expectedInt,expectedDouble,iterations
100,200,0.5,0.5,300,1.0,100
-100,-200,-0.5,-0.5,-300,-1.0,100
100,-200,0.5,-0.5,-100,0.0,100
0,0,0.0,0.0,0,0.0,100
1000,1000,999.99,999.99,2000,1999.98,100
-1000,-1000,-999.99,-999.99,-2000,-1999.98,100
1000,-1000,999.99,-999.99,0,0.0,100
1,999,0.01,999.98,1000,999.99,100
-1,-999,-0.01,-999.98,-1000,-999.99,100
500,500,500.5,500.5,1000,1001.0,100
