int1,int2,double1,double2,expectedInt,expectedDouble,iterations
1000,1000,1000.0,1000.0,0,2000.0,100
-1000,-1000,-1000.0,-1000.0,0,-2000.0,100
1000,-1000,1000.0,-1000.0,2000,0.0,100
-1000,1000,-1000.0,1000.0,-2000,0.0,100
0,0,0.0,0.0,0,0.0,100
500,-500,500.0,-500.0,1000,0.0,100
333,777,333.0,777.0,-444,1110.0,100
999,1,999.0,1.0,998,1000.0,100
1,999,1.0,999.0,-998,1000.0,100
250,750,250.0,750.0,-500,1000.0,100
