int1,int2,double1,double2,expectedInt,expectedDouble,iterations
1,2,1.5,0.5,3,1.0,100
-1,-2,-1.5,-0.5,-3,-1.0,100
1,-2,1.5,-0.5,-1,2.0,100
0,0,0.0,0.0,0,0.0,100
500,500,500.5,499.5,1000,1.0,100
-500,-500,-500.5,-499.5,-1000,-1.0,100
1000,-1000,1000.0,-1000.0,0,2000.0,100
1,1,1000.0,0.0,2,1000.0,100
1,1,500.0,500.0,2,0.0,100
1,1,0.0,1000.0,2,-1000.0,100
