int1,int2,double1,double2,expectedInt,expectedDouble,iterations
1,2,0.0,0.0,3,0.0,100
0,0,0.0,0.0,0,0.0,100
-1,-2,0.0,0.0,-3,0.0,100
1000,-1000,0.0,0.0,0,0.0,100
-500,500,0.0,0.0,0,0.0,100
333,333,0.0,0.0,666,0.0,100
999,1,0.0,0.0,1000,0.0,100
-999,-1,0.0,0.0,-1000,0.0,100
123,456,0.0,0.0,579,0.0,100
-123,-456,0.0,0.0,-579,0.0,100
