int1,int2,double1,double2,expectedInt,expectedDouble,iterations
5,3,0.0,0.0,2,0.0,100
-5,-3,0.0,0.0,-2,0.0,100
5,-3,0.0,0.0,8,0.0,100
-5,3,0.0,0.0,-8,0.0,100
0,3,0.0,0.0,-3,0.0,100
5,0,0.0,0.0,5,0.0,100
1000,500,0.0,0.0,500,0.0,100
-500,-1000,0.0,0.0,500,0.0,100
1000,-1000,0.0,0.0,2000,0.0,100
-1000,1000,0.0,0.0,-2000,0.0,100
