int1,int2,double1,double2,expectedInt,expectedDouble,iterations
1,2,1.1,2.2,3,3.3000000000000003,100
-1,-2,-1.1,-2.2,-3,-3.3000000000000003,100
1,-2,1.1,-2.2,-1,-1.1,100
500,500,500.5,500.5,1000,1001.0,100
-500,-500,-500.5,-500.5,-1000,-1001.0,100
500,-500,500.5,-500.5,0,0.0,100
0,0,0.0,0.0,0,0.0,100
1000,-1000,999.9,-999.9,0,0.0,100
333,666,333.3,666.6,999,999.9000000000001,100
-333,-666,-333.3,-666.6,-999,-999.9000000000001,100
