int1,int2,double1,double2,expectedInt,expectedDouble,iterations
0,0,0.0,0.0,0,0.0,100
100,-100,1.0,-1.0,200,0.0,100
-100,100,-1.0,1.0,-200,0.0,100
100,50,0.5,0.5,50,1.0,100
50,100,0.5,0.5,-50,1.0,100
-50,-100,-0.5,-0.5,50,-1.0,100
-100,-50,-0.5,-0.5,-50,-1.0,100
0,0,0.0,0.0,0,0.0,100
1000,-1000,10.0,-10.0,2000,0.0,100
-1000,1000,-10.0,10.0,-2000,0.0,100
