int1,int2,double1,double2,expectedInt,expectedDouble,iterations
0,0,0.0,0.0,0,0.0,100
1000,1000,1000.0,1000.0,2000,2000.0,100
-1000,-1000,-1000.0,-1000.0,-2000,-2000.0,100
1000,-1000,1000.0,-1000.0,0,0.0,100
-1000,1000,-1000.0,1000.0,0,0.0,100
500,250,500.5,250.25,750,750.75,100
-500,-250,-500.5,-250.25,-750,-750.75,100
500,-250,500.5,-250.25,250,250.25,100
-500,250,-500.5,250.25,-250,-250.25,100
1,2,1.1,2.2,3,3.3000000000000003,100
