int1,int2,double1,double2,expectedInt,expectedDouble,iterations
1000,0,1000.0,0.0,1000,1000.0,100
0,-1000,0.0,-1000.0,1000,-1000.0,100
500,500,500.0,500.0,0,1000.0,100
-500,-500,-500.0,-500.0,0,-1000.0,100
1000,-1000,1000.0,-1000.0,2000,0.0,100
-1000,1000,-1000.0,1000.0,-2000,0.0,100
333,-333,333.0,-333.0,666,0.0,100
-333,333,-333.0,333.0,-666,0.0,100
1000,999,1000.0,999.0,1,1999.0,100
-999,-1000,-999.0,-1000.0,1,-1999.0,100
